║                                 Ouest :                     Est :
║                                 ╔══○O○══╗                   ╔══○O○══╗
║                                 ║███████║                   ║███████║
║                                 ║███████║                   ║███████║
║                                 ║███████║                   ║███████║
║                                 ╚══○O○══╝                   ╚══○O○══╝