║                                               % :
║                                               ╔══○O○══╗
║                                               ║███████║
║                                               ║███████║
║                                               ║███████║
║                                               ╚══○O○══╝